-11 -11 -11 -11 -11 -11 -99 22
-99 -11 -99 -11 -99 -11 -99 -99
-11 -99 -11 -99 -11 -99 -99 23
-99 -11 -99 -11 -99 -11 -99 -99
-11 -99 -11 -11 -11 -11 -99 22
-11 -11 -99 -11 -11 -11 -99 -99
-11 -11 -11 -11 -99 -99 -99 1
-99 -99 -99 -99 -99 -99 -99 -99
-99 -99 -99 -99 -99 -99 -99 -99
