-99 -99 -99 1 2 3 2 4 -99
-99 -99 -11 -11 -11 3 -11 2 -99
-99 -11 -11 -11 3 2 3 3 -99
-11 -11 -11 -11 -11 -11 -11 2 -99
10 -11 -11 1 -99 -99 -99 -99 -99
-11 -11 -11 -11 -11 -11 -11 -99 -99
-11 -11 -11 -11 -11 -11 -99 -99 -99
14 -11 -11 10 -11 -99 -99 -99 -99
