3 2 0 3 1 2 0 2 2
0 1 1 0 4 2 3 2 3
0 -11 3 2 -11 1 1 -11 2
4 -11 3 2 -11 4 2 -11 2
4 -11 2 1 -99 3 1 -11 4
0 -11 2 0 -11 1 1 -11 13
3 -11 0 1 -11 1 3 -11 3
0 30 4 1 31 3 1 33 4
3 1 1 4 32 4 3 0 3
